11111111111111111
10001000000010001
10111100000000101
11100010001000111
11111111111111111
